DVEVPCWDKDLKKKYEKKFRDCVFFKR	DVEVPCWDKDCKKKYEKKFRDCVFFKR
ERPCKKLVKVYEAALVPKIKKEWLDCA	ERPCKKLVKVYEAALVPKIKKEWLDCA
KDGCAKLKAKLKDELRRDWDKVRLHCE	KDGCAKLKAKLKDELRRDWDKERLHCE
EDAIDVLCPAFKPKICEKYKKRYLCVC	EDAIDVLCPAFKPKICEKYKKRYLCVC
EKKFKCLRCECEKEIKKKRKKELLEEE	EKKFKCLRCECEKEIKKKRKKEIFEEE
PCKVEKFEEKYCECFEECCAAKCFLEK	PCKLEKFEEKYCECFEECCVAKCFKDK
DDAIGCLECKCKERYEEHWRDCLLRVK	DDALGCLECKCKERYEEHWRDCLLRVK
PCKCDEYKKEYVEVLDPELEAKCLCDP	PCKCDEYKKEYVEVLDPELEADCLCDE
KNEDKRLCECWVAVLRADFDEDRLFKG	KNEDKRLCDCWVAVLRADFDEDRLFKG
KEEMCALHACCCPCLDPDCEAWRFRRE	KEEMCALHACCCPCLDPDCEAWRFRRE
EKEKRELCKCWRKALVAKIKDKELDKA	EKEKRELCKCWRKVLVAKIKDKELDKA
ECKFEKLCECYEPDCVKKYKKDLFLEA	ECKFEKLCECYERDCCKKYKKDLFLEA
PLKVKELKKEIDKKWKEVYCKVLFLED	PLKLKELKKEIDKKWKEVYCKVLFCED
ERPKKELCKEYEKALCPKIKKEMLCVA	ERPKKELCKEYEKALCPKLKKEMLCVA
EEGVCALEAAVCPCFEKKCRECFLRVK	EEGVCCLEAAVCGCFEKKCRECFLRVR
EEGVEKLVEKWEEDIVKKYKKCFFCAA	EEGVEKLVEKWEEDIVKKYKKDFFCAC
KDDCEKLVEKWKEALCKDLDEKRLRKC	KDDCEKLVEKWKEALCGDLDEKRLRKC
DRDMEELCGCCDKDCVKKYRECYIERR	DRDMEELCCCCDKDCVKKYRECYIERR
KDAIGCLECRCKEKYEEDWEDCYLRVR	KDAIGCLECRCKEKYEEDWEDCYLRVR
PEGCEKLEEKYKDKYEKCYCEKCFCCK	PEGCEKLEEKYKDKIEKCYCEKCFCCK
KEGCEKCCEAYRPRLDPDYEEKRLRCA	KEGCEKCCEAYRPRLDPDVEEKRLRCA
KDELECLVPVWREKLDAEVDDKYLRKK	KDELECLVPVWREVLDAEVDDKYLRKC
KDEKKELCKVFVAVLGAELEDERLRKD	KDEMKELCKVFVAVLGAELEDERLKKD
DKKCPDWKKDCVKVYKERLRACVLLED	DKKCPDWKKDCVKVYKERLRACVLFED
DDPCAVLEAKLEEDFERKYRKEFLEWK	DDPCAVLEAKLEEEFERKYRKEFLEWK
KVEVKKLRDELVKVWRKDLEAWCLDKD	KCEVKELRDELVKVWRKDLEAWCLDKD
KEEVPVLEAKLVGCYDEDLEECFLRKK	KEEMGVLEAKLVGCYDEDLEEAFLRKK
CCKCKKLKDKIEDEYKKCIWKECLCEE	CCKCKKLKDKIEDEYKKCEWKECLCEE
KEAMGCLECCCKPKMEEEYEDCYFRVK	KEAMGCLECCCKPKMEEDYDDCYFRVK
PCKLDELCKEYKKKLCECYCDKLLCEC	PCCLDELCKEYKKKLCECYCDKLLCEC
KEGCKKCKKEFVKCWRPDLEPDCFRCE	KERCKKCKKEYVKCWRPDLEPDCFRCE
PCKDDEYRKEYVKVFCPCLKADCFLEA	PCKDDEYRKEYVKVFCPCLKADCFLEA
DDPVPVLCPCFDPKCEKKYRKKYLYEK	DDPVEVLCPCFDPKCEKKYRKKYLDEK
EKPMRCLCPCCDKEIKKKYKKKYLDVC	EKPMRCLCPCCDKEIKKKYKKKYLDVC
AVACEKWDKKYKEKYEDCYCDKLLICK	AVCCEKWDKKYKEKYEDCYCDKLLICK
EKGCPAIEAELCKCWEEKCRAVFLDVK	EKGCPAIEAELCKCWEEKCRAVFLDVK
KDELKCLCPCCGKEVREDIEDCYLDKD	KDELKCLCPCCGKEVREDIDDCYLDKE
KDAVEKLCECFKPKLDEEYDDRYLRVK	KDAIEKLCECFKPKLDEEYDDRYLRVC
EKKVPCLCGCFDKDCRKKYKKCEFDED	EKKVPCLCGCFDKECRKKCKKCEFDED
DKACPKWDKELKKKYEEKLRAKCFLVK	DKACPKWDKELKKKYEEKLRAKCFLVK
DKPCPALEACLCACLDEKCRAKFLYVK	DKPCPALEACLCACLDERCRAKFLYVK
GCKCPKLKDKLKDKFEDCFCKVCLLED	PCKCAKLKDKLKDKFEECFCKVCLLED
EDGVEKLEECVCPKFDKKCKEKFFRVK	EDGVEKLEECVCPKFDKKCKEKFFRVR
EKGVPALEACLCACFEKKCKRKELDVK	EKGVEALEACLCACFEKKCKRKFLDVK
KCKCKECKKEIVKALKGDLDPECLCCE	KCKCDECKKEYVKALKGDLDPECLCCE
KDRLPKLKDCFCPCLRGECDADRFRED	KDRLDKLKDCFCPCLRGECDADRFREE
EDPMPCLCPAFEPEIEKKYKKCYLYVC	EDPMPCLCPAFEPEIEKKYKKCYLEVC
ECKFEKIEEEYCECFEPKCRAKCFKER	ECKFEKIEEEYCECFEPKCRAKCFKER
AVCIKRLKCKLKDEYCKCYCDELLCKD	AVCIKRLKCKLKDEYCKCYCDELLCKC
PCKLKEFRREYVACLKPKLKAELFCEE	PCKLKEFRREYVACLKPKLKAELFEEE
DDEMECLECCCKGKLEKDCREKYLRVK	DDDIECLECCCKGKLEKDCREKYLRVK
EREVPCLEGCLCCKCEKKFRECFFDKK	EREVPCLEGCLCCKMEKKCRECFFDKK
ERDFKELHRCFEACCKKKFKKDIFDRE	ERDFKELHRCFEACLKKKCKKDIFDRE
KCKLEKFCEKFEDEICKEYDKDIFCEC	KCRLDKFCEKVEDEICKCYDKDIFCCC
KDGCACLKAAIGDELRRDWEPCRLRCE	KDGCACLKAAIGDELRRDLEPCRLRCE
DKKVPCLKPECEKEIKKRIKKCVLEEE	DKKVKCLKPECEKEIKKRLKKCVLEEE
KDKCPCLKAACEPEIKKDWEKCRLEEE	KDKIPCLKAACEPEIKEDWEKCRLEEE
DRKVKVLCGCFEKECCKKYKKRYLLEC	DRKMKVLCGCFEKECCKKYKKRYLLEC
REDMCAFEACLCACFDKDCEEPFFDKK	KEDMCAFEACVCGCFDKDCEEPFFDKR
PVKCARWDDKLKEKYEDCFCAELLCEK	PVKCERWDDKLKEKYEDCFCAELLCEK
KEDVEKLCECYRPCLDKDFDEKFFKRA	KEDFEKLVECYRECLDKDFDEKFFKRA
KEEVPALRACICPCLKGECEADRFDKE	KEEVPALRACICACLKGECEADRFDKE
DRKFKKLCACFEPDLRKKIKKEFLEEE	DRKFKKLCDCVEGDLRKKIKKEFLEEE
DRPVKELVKVMDKDLVKKYKDKELYVA	DRPVKELVKVMDKDLCKKYKDRYLCVA
PCECEEWDKDYKKKYEECLGDKFLLKR	PCDVEEWDKDYKKKYEECLGDKFLLKR
DRGMACLEACCEGDYEKKYRKVFFEER	DRGMACLECCCEGDYEKKYRKVFFEER
DRDFKELVRKCEKELCKKRRKEILCKC	DRDFRRLVCKCEKELCKKRRKEILEKC
DKEKPEWRKELVKVLKARLRAEFLFKD	DKEKKEWRKELVKVLKARLRAEFLYKE
KDDMEKLCECFKEDLGPEMEEDRLRRG	KDDMEKLCDCFKEDLGPEMEEDRLRRG
AVEVAEYDKDLVKKYKEAFGAVLFLKD	AVEVKEYDKDIVKKYKECFGAVLFLKD
DDGCEVLVAALKDKIEKDYDKKYLRVK	DDGCEVLVAAVKDRIEKDYDKKYLRVK
PLCLKDLCKEHKKKICECYCDRLLCEC	PLCLKDLCKEHKKKICECYCDRLLCEC
KEGCEKLVECWKPCLDPDLEEKRLRCP	KEGCEKLVEAWKPCLDPDLEEKRLRCP
DKECPEWHKVLVKALRGDLRACFLYKE	DKECPEWHKVLVKVLRGDLRACFLYKE
DDDMPCLEGCCKGKIEKDLRDCYLRKK	DDDMECLEGCCKGKIEKDLRDCYLRKK
AVECAEWEKDLKKKYEDVFGEVCFLKR	AVECAEWEKDLKKKYEDVFGEVCFLKR
ACKCEKMDDKYKERYEECLCEKCLCDK	ACCCEKMDDKYKERYEECLCEKCLCDK
ECKKEEWCKEYDKRCCPKLKRRMFLEA	ECKKEEWCKEYDKVCCPKLKRRMFLEA
DCKCDKLVREYEDELCKCYKKRCLCEC	DCKLDKLVREYEDELCGCYKKRLLCEC
DRPCEELCKVYEPRLCKKYRKKWLCCA	DRPFEELCKEYEDRLCKKYRKKWLCCC
KDKCEKLCERFKDKMCEEYDKKRFRCA	KDKCEKCCERFKDKMCEEYDKRRFRCC
PCKVAKLRDKIEGEIKKRRDKDLFEEE	PCKVAKLRDKIEGEIKKCRDKDLFEEE
PCKVKELKKEIEKAWKEALWAECLCEE	PCKVKELKKEIEKAWKECLWAECLCKE
KLAIACLKAELKKEYRKAYGDVLLMVD	KLAIACLKCECKKEYRKDYDDVLLMCD
AVKCAKWDDKLKEKYEECYCDVLLMEK	AVKCAKWDDKLKEKYEECYCDVLLMEK
DCELKELCREYEAALCAKIKKDMFCRC	DCCLKELCREYEAALCAKIKKDMFCRC
PCACDELDKKYKEKWEECLCEKCLCCK	PCCLDELDKKYKEKWEECLCEKCLCCK
DKAVGCLEGCCEGKYEEKYRKCFLEEK	DKAMGCLEGCCEGKYEEKYRKCFLEEK
KDPCDVLCPRLKEELCRDYCKEYLCCC	KDPCDVLCCRLKEELCRDYCKEYLCCC
PCRLKEYRKEYVKCWKGDLWAECLKEE	PCRLKEYRKEYVKCWKGDLWAECLKEE
EKPMRCLVGCCEKPIKRKLRRCWLDVE	EKRMRCLVGCCEKPIKRKLRRCWLEVE
EKKCKKLCKVWVPAIKPRIKRDRLEEP	EKKCDKLCKVWVPAIKGRIKRDRLEEP
DRPKKELVKEYEKRLCAKYKDRYLCEC	DRCLKELVKEYEKRLCAKYKDRYLCEC
ACKMKECKRDHEKEYKDVEVKELFCED	ACKLKECKRDHEKEYKEVEVKELFCED
AVEMREWVKEYRKVLVAVLCDCMLKKG	AVEMREWVKEYRKVLVAVLCDCMLKKG
EDDKEELCKEYRKVLCADLKEKMLCRA	EDDKEELCKEYRKVLCADLKEKYLCRA
RDEMKRLCCKCEEELCKDYEDELLCRC	RDEMKRLCCKCEEELCKDYEDELLCRC
KDACPVLKAKLKDKYDEEWDDELLHCD	KDACAVLKAKLKDKYDEELDDELLHCD
ACCIKELKKKHEDAYCECLCPELLCKE	ACCIKELKKKHEDAYCECLCPELLCKE
EDGCEKLCPVFEPEIVKKYKKRYLYEA	EDGCEKLCPAFEPEICKKYKKRYLYEC
KELFCREELCPCGDIEKIKDEEYCERL	KELFCREELCDCGDIRKDKDEEYCERY
EKLLCCPELCECCEYKKKKRCCYCERI	EKLLCCPELCDCCEYRKKKRCCFCERI
EKCLRCKDCDPVKKLEERKKDRYDKVI	EKCLRCKECDCVKKLEERKKDRYDDVR
RREFLREHWCDCACLKKDKDEEICEKY	RREFLREHWCDCACLKKDRDEEICEKY
ERCFEKKCLGAEDKMCKKGKKRYREEC	ERCFEKRCLDREDKMVKKGKKRYREEC
EECLEEKCLRAKEKMCKCACDKYKKCC	EECIEERCLRAKEKMCKCACDKYKKCC
AVCLEREECKKREKYEECKCDKLRKKR	AVCLEREECKKREKYEECKCDKLRKKR
KERLLVGRYCEVACLKADEEEDIVAKY	KEDLLVGRYCEVACLKADEEEDIVDKY
KELFCKEKLCECPEWRKDEDKDCCEEY	KERFCKPKLCECPEWRKDEDKDCCEEY
ERRFLRKRYCECACLKAKRKKDICDEY	ERRFKRLRYCECAALKAKRKKDLFDEE
KEDLLVGEYCECGECRKDKEEDYCARF	KEDLCVGEYCECGECRKDKEEDYCARM
KDCLLVECLRGEDELCKCGCKEYKEDL	KDCLLVECCREEDELCKCGCKEYKEDL
PECFEKEEMKKKEDYEKCKVKRFKEEY	PECFEKEEMKKKEDYEKCKCKRFKEER
AVCLREKKFDGRKVYCKVECDCLDKKY	AVCLREKKFDGRKVYCKVECDCLDKKY
KELLYKEKIREEDEYRKVEVKCCKEEI	KELLYKEKIREEDEYRKVEVKCCKEEI
DKLFCCKEFCDCCCFKKKERRCFCEKY	DKLFCCPEFCDCCCFKKKRRRCFCEKY
RDCLLCECCRKKEELEREPCKEYKEDL	RDCLLCECCRKKEELEKEPCKEYKEDC
DRYFREKRLEEEKEIKKKRRKEWEEEL	DRYFREKRLEEEKEIKKKRRKEWEEEL
EDCLEKGCLRKEEKMEEKGKKRYREEC	EDCLEKGCCRKEEKMEEKGKKRYREEC
ACLFYKEELDPCDCWEDIKVEKFKKCY	ACLFYKEELRPCDCWEDIKVEKFKKCY
PCLLYEKELEKDECWVKVKVEKFDKDF	PCLLDEKELEKDECWVKVKVEKFDKDF
DRCFCKPCLKEEDEIRKKRKKELREEC	DRCFCKPCLKEEDEIRKKRKKELIEEC
KEEFLREEYKKVECLDKDKEAEFCKKY	KEEFCREEYKKVECLDKDKEAEFCKKY
KECFFKEKLKEEDELKKCECKECKEEY	KERFFKEKLKEEDELRKCECKECKEEY
PKLLCCKRMDEVKCYKEIKVACLDEKW	AKLLCCKRMDEVKCYKEIKVACLDEKW
DKCFYCSECRKEDRYEDCKCKRLREVI	DKCFYCSECRKEDRYEDCKCKRLREVC
EDCLLKGCLAEDADLCKKGKKDYCEDC	EDCLLKGCLAEDADLCKKRKKDYCEDC
AELLCKNELKKCECWRKIKMRCFCEDY	AELLCKPELKKCECWRKIEMRCFCEDY
PCLFREKRLEGVKCWKACEMADCDKKY	CCLFREKRLEGVKCWKKCEMADCDKKY
EKFFREKCLEEDKCLRPKGKRKYEDDL	EKYFREKCLEEDKCCRPKRKRKYEDDM
CECLEKEEIKKKEKYEKCKVERCKKER	CECLEKEECKKKEKYEKCKCECCKRER
CCLFYKEKLKKEECYCKCEVKECKKEY	ACLFYKEKLKKEECYWKCEVKECKKEY
ACLFYEKELDPHKCWWDVKVEKFDKKW	ACLFYEKELDPHKCWWDVKVEKFDKKW
CELFMKDKMKEVDCWKECEVAECKECW	CELFMKDKMKEVDCWKDCECAECKECW
KERFCKGRYCECPCCRKDEDKDICERY	KRRFCKGRYCECPCCRKDEEKDICERY
DKCLHCKCLEEDKKYCEVGCKRLEEEC	DKCLHCKCLEEDKKYCEVGCKRLEEEC
KRFFLKPCLCEDRDLRAKDKKDYEEEL	KRRFLKPCLCEDRDLRKKDKKDYDEEL
EKYFCAAEYCECACLRKKKKRDWCERM	EKYFCAAEYCECACLRKKRKRDWCERM
DKCLREKDCEEDKKYCEVACDRYECKC	DKCLREKDCEEDKKYCEVGCDRYECKC
AECLDERECRPREKYEEVKCDKFRKCC	AECLDERECRPREKYEEVKCDKFRKCC
AVLLCEKRMDPVKCYKECEVACLDKKY	AVLLCEKKMDPVKCYKECEVACLDKKY
ERLLREKCLEEDKECRKVAVECYDKKF	ERLLREKCLEEDKECRKVAVECYDKKF
KECLEKECLRAKEELCKDGDEKYKKCC	KECLEKECLRGKEELCKDGDEKYKRCC
KELFCKEEIKKCDCYEKIKVECCKECY	KELFCKEEMKKCDCYEKIKVECCKECY
PCRFFKERLKKCECFRKIDVKECCEEY	PCRFFKERLKKCECFRKCDWKECCEEY
DKCLREKCLEEDRCLCGKGKKKYEDEL	DKRLREKCLEEDRCLCGKGKKKYEDEC
EEFLREKEFEKVKCLEKCKFEKFDKKM	EEELREKEFEKVKCLEKCKCEKFDKKM
PRLFREKKLDEEKEYRKVECPCFDEKY	PRLFREKKLDEEKDYRKVECPCFDEKY
AVLLREKEFDEKKDYWKVECDCLDKKY	AVCLREKEFDEKKDYWKVECDCLDKKY
KECFDKEEMKKVDCFEDDKDEECKRCY	KECFDKEEMKKVDCLEDDKDEKCKRCY
EDCIECGECRKKDKYEKCKCERYKRVC	EDCIECGECRKKDKYEKCKCERYKRVC
KELIYCEKLRPKKEYCKVACDCYDKRF	KELIYCEKLREKKEYVKVACDCYDKRF
AVCFREKDLDGDKVYCDCECEKLDKKF	AVCFREKDCDGDKVYCDCECDKLDKKF
KERLLKDKYREVECLKPEEDADIKADL	KERLLKDKYREVECLKPEEDADIKADL
KECLLRERLREVECLCADEDEDIKKKY	KECLLRECYRECECLCKDEDEDIKKKY
EKLLYEKCLDADKKWVEVAVKRFDKEF	EKLLREKCLDADKKWVEVGVKRFDKEF
PEEFCEGEWCDVACLDPCEKADFCKKY	PEEFCEREWCDVACLDPCEKADFCKKY
KDCLEKECCRKKEKLEKEGDDRYKRVC	KDCLEKECCRKKEKLEKEGDDRYKRVC
ECCLDEKCLEADRCLCPVGKEKYDKDC	ECCLDERCLEADRCLCPVGKEKYDKDC
ERRFCKPCLAEEEEIRKKRKKDYKEEL	ERRFCKPCLAEEPEIRKKRKKEYKEEL
DRCLREKCCEEEKEICKKRCKELICRC	DRCLRELCCEEEKEICKKRCKELICRC
CCFLRERKLEEDKCWKEVECECCDKCW	CCFLRERKLEEDKCWKEVECECCDKCW
KECFYKEKLRPEDEYCKCECKELKEEL	KECIYKEKLRGEDEYCKCECKELKEEL
EDCLEKKCLAKDAKLEKKKKEKYRACC	EDCLEKKCLARDAKLEKKRKEKYVDCC
ERFFDKRCLEADRKMCKVGKKRYRKEC	ECCFDKRCLDADRKMVKVGKKRYRKEC
ERLFCKPELDECRCYRKIKVKCCCEEY	ERRFCKPELDECRCYRKIKVKCCCEEY
KEFLIKDRYEECKCWRKDEMCDCDKCW	KEFLIKDRYEECKCWRKDEMCDCDKCW
AECLEREECKKKEKYEKCKCDCFKKKR	AECLEREECKKKEKYEKCKCDCFKKKR
PCELREKHFEEVKCLCAMEREKFEKKM	PCELREKHWEEVKCLKAMEREKFEKKM
KERLIKEKYREVECLKGEDDADIWEDW	KERLLKEKYREVECLKGEDEADLWEDW
DDCLLCGCCRKKEKLERDPCKRYRADL	DDCLLCGCCRKKEKLERDGCKRYRAVC
KECFDEEELRKKECLEPCKCEKFRKCC	RECFDEEECRKKECLEPDKCEKFRKCC
PRCFCRKELCECGCLRKCEVKEICEEY	PRCFCRKELCECGCLRKCEVKELCEEY
KRCLRCKCFDEDKEYRKVRCDEYDDKC	KRCLRCKCFDEDKEYRKVRCDEYDDKC
KECLCKEKCRGEDEYCKCECKELKEEC	KERLDKEKCREEDEYCKCECKELKEEC
ACMFFKEKMKKEEDYEKCEVKELKEEY	ACMFFKEKMKKEEDYEKCEVKELKEEY
EKLFYCKELDKKKKMEKFKVEKYDKKF	EKLFYCKELDKKKKHEKVKVEKYDKKF
EKCFREKDCDEDKRYVECKCERWDCCC	EKCFRERDCDREKRYVECKCERWDCCC
KECLYKECLRAKEEYCKLPCDRYKKCC	KECLYKECLRAKEEYCKVPCDKYKRCC
KDRLLCGKCRGVDKICEEEDDRYKEEL	KDRLHCGKCREVDKICEEEDDRYWEEC
EKRLLCGCLCKCPKLEEKKDERYCAEL	EKRLCCPCLCECPKLEEKKDERYCDEC
EKLLDCSELRKKDKYEEVKVEKFKRCR	EKVLDCSEIRKKDKYEEVKVEKFKRCR
DKLLRCKDCDPDKKYEEVKCDKFDKVR	DKVLREKDCDPDKKYEEVKRDKFDKVR
KERLIKGKYAEVAVLKADDDAERVDCE	KERLIKGKYAEVACLKADDDAERFDCE
KERLCCGEWCCCCCLKKDEDACFCEKY	RERLCCLEWCCCCCLKKDEEACFCEKY
DKELRCKCFEEVKKLKEKGREKYEDKC	DKELREKCCEEVKKLKEKRKDKYEDKC
KCCLHKEKLEEDKEYCEVECKDLDCEW	KCCLHKRKLEEDKEYREVECKDLDCEC
KVCLDEEKCREVDEWCECECDELDCCL	KVCLDEEKCREVDEWCECECDELDCCW
DDCLYCGCCRGKEKYCKCGCKRYKCEC	DDCLECGCCRGKEKYCKCGCKRYKCEC
EKELREKDFEEVKCLKAKKREKFEKKW	EKELREKDWEEVKCLKAKKREKFEKKM
EKCFCCKKCGDVDCIKKCERAELCEKY	EKCFCCKKCRDVDCIKKCERAELVEKY
KEMFYKDGLKAKDDLCKLACKEYKECL	REMFYKEGLKAKDDLCKCACKEYKECL
CELFCKEEMKKCECYEKCEVECCKECY	CERFCKEEMKKCECYEKCEVECCKEEY
PCCLREKKLEHDKVLCACDCDDLDKKY	PCCLREKKREHDKVLCACECDDLDCKY
CCLFMEKKLDEDKCYRKVEVECCDKKY	CCLFMEKKLDEDKCYRKVEVECCDKKY
EKLLREKDLEPVKVMDEVKVEKLDKKF	EKLLREKDLEPVKCMDAVKVEKLDKKY
KDCLLCGCCACKEKLEEDGDDRYERVC	KDCLLCGCCACKPKLEEDGDDKYIRVC
EKCLRCKECECRKKIEKMKCEKYDKKC	EKELRCKECECRKKIEKDKCEKYDKKC
EEFLLCKELEPRGKMDEDKVEKYDRKM	EEFLECKECEPRDKMDEDKDEKYDRKM
PCCFREKVLEREKCLCKCECEECDCKY	PCCFREKVLEREKCLCKCECEECDCKY
